o - - - - - - -
1 - - - - - - -
1 - - - - - - -
E - - - - - - -
- - - - - - - -
- - - - - - - -
- - - - - - - -
- - - - - - - -