S 1 2 3 4 5 6 5
- - - - - - - 4
3 4 5 4 3 4 - 5
2 - - - - 3 - 4
1 - E - - 2 - 3
2 - 1 1 2 2 - 3
2 - - - - - - 2
3 2 2 1 2 3 2 1