o 2 3 4 3 2 1 1
- - - - - - - 1
- - - - - - - 2
2 1 E - - - - 1
1 - - - - - - 2
2 1 1 - - - - 3
1 - 1 2 1 1 - 2
E - - - - 1 1 1